Row
{1,1,0,1,-}
{1,1,0,0,-}
{1,1,0,0,-}
{1,1,0,0,-}
{1,1,0,0,-}
{0,1,0,0,-}
{0,0,1,0,X-S}
Row
{0,1,0,1,-}
{0,1,0,0,-}
{1,1,0,0,-}
{0,1,1,0,-}
{0,1,1,1,-}
{0,0,1,1,-}
{0,0,1,1,-}
Row
{0,0,1,1,-}
{0,0,1,1,-}
{0,1,0,1,-}
{1,0,1,0,-}
{0,0,1,1,-}
{0,0,1,1,-}
{0,0,1,1,-}
Row
{0,0,1,1,-}
{0,0,1,1,-}
{0,0,0,1,-}
{0,1,0,0,-}
{0,0,1,0,-}
{1,0,1,1,-}
{0,0,1,1,-}
Row
{0,0,1,1,-}
{0,0,1,1,-}
{1,0,1,1,-}
{1,0,1,1,-}
{0,0,1,1,K}
{0,1,0,1,-}
{0,0,1,0,-}
Row
{0,0,1,1,-}
{1,0,1,1,-}
{1,1,0,1,-}
{1,1,0,0,-}
{1,0,1,0,-}
{0,0,1,1,-}
{0,0,1,1,-}
Row
{0,0,0,1,-}
{1,1,0,0,-}
{1,1,0,0,-}
{1,1,0,0,-}	
{1,1,1,0,-}
{0,0,1,1,-}
{0,0,1,1,-}
Row
{1,0,0,1,-}
{1,1,0,0,-}
{1,1,0,0,-}
{1,1,0,0,-}
{1,1,0,0,-}
{1,0,1,0,-}
{0,0,1,1,-}
Row
{0,1,0,1,-}
{1,1,0,0,-}
{1,1,0,0,-}
{1,1,0,0,-}
{1,1,0,0,-}
{1,1,0,0,-}
{1,0,1,0,-}
Row
{1,0,0,1,-}
{1,1,0,0,-}
{1,1,0,0,-}
{1,1,0,0,-}
{1,1,0,0,-}
{1,1,0,0,-}
{1,1,0,0,B-E}