Row
{0,1,1,1,-}
{0,1,0,1,-}
{0,1,1,0,-}
{0,1,0,1,-}
{0,1,1,0,-}
Row
{0,0,1,0,B-W}
{0,0,1,1,-}
{0,0,1,1,-}
{0,0,1,1,-}
{0,0,1,1,-}
Row
{0,0,1,1,-}
{0,0,1,1,-}
{0,0,1,1,-}
{0,0,1,1,-}
{0,0,0,1,X-E}
Row
{0,0,1,1,-}
{0,0,1,1,-}
{1,0,0,1,-}
{1,0,1,0,-}
{0,0,1,1,-}
Row
{1,0,0,1,-}
{1,0,1,0,-}
{1,1,0,1,K}
{1,1,0,0,-}
{1,0,1,0,-}
